11111111010101111110101011111111
11111111010101111110101011111111
11000001111111111111111110000011
11000001111111111111111110000011
11000001111111111111111110000011
11000001111111111111111110000011
11000001111111111111111110000011
11000000011111111111111000000011
11000000011111111111111000000011
11000000011111111111111000000011
11000000011111111111111000000011
11000000011111000011111000000011
11000000011111000011111000000011
11000000011111000011111000000011
11000000011111000011111000000011
11000000000000000000000000000011
11000000000000000000000000000011
11000000000000000000000000000011